{
  "levelNum": 1,
  "width": 50,
  "height": 50,
  "level": [
    "00000000000000000000000000000000000000000000000000",
    "0                         0                      0",
    "0                        0                       0",
    "0   S                   0                        0",
    "000000000              0                         0",
    "0        0             00000000                  0",
    "0         0                   0                  0",
    "0          0000 0 0 0 0       0                  0",
    "0                     0       0                  0",
    "0^^^^^^^^^^^^^^^^^^^^^0       r                  0",
    "0                     0       0                  0",
    "0                     R       0 000000000000000  0",
    "0                     0       000 0 0 0    0  0  0",
    "0                     0       00  0        0  0  0",
    "0                     0                       0000",
    "0                      0                       r 0",
    "0                       00  0000000  0 0 0 0 00000",
    "0                       00^^00    0  0 0 0 0 00000",
    "0                                 0^^ ^ ^ ^0 00000",
    "0      000000000000000000000000000000000000  00000",
    "0      0            p             000000000  00000",
    "0      0                                     00000",
    "0      0                                     00000",
    "00000000                   00 0  0 00 00 000000000",
    "0                   0 0                          0",
    "0          0 000 0       0                       0",
    "0                               0   r            0",
    "0           0 0       0             0            0",
    "0                           0                    0",
    "0              0  0    0                      r000",
    "0                                                0",
    "000R                               000000        0",
    "0                 0  0   0       0               0",
    "0                              0                 0",
    "0                                                0",
    "0                            0              0    0",
    "0               0 00                             0",
    "0              0        0       0                0",
    "0   R         0                                  0",
    "0   0   0 0 000                    00   000      0",
    "0                         P         00    0      0",
    "0^^^^^^^^^^^^^^^^^^^^^^^^^0^^^^^^^^^^^0   0^^^^^^0",
    "0                                     0 F 0      0",
    "0                                     00000      0",
    "0                                                0",
    "0                                                0",
    "0                                                0",
    "0                                                0",
    "0                                                0",
    "00000000000000000000000000000000000000000000000000"
  ]
}
