{
  "levelNum": 1,
  "width": 1,
  "height": 1,
  "level": [
    "##################################################",
    "#                         #                      #",
    "#                        #                       #",
    "#                       #                        #",
    "####S####              #                         #",
    "#        #             ########                  #",
    "#         #                   #                  #",
    "#          #### # # # #       #                  #",
    "#                     #       #                  #",
    "#^^^^^^^^^^^^^^^^^^^^^#       r                  #",
    "#                     #       #                  #",
    "#                     #       #                  #",
    "#                     #       #                  #",
    "#                     #       ##    ##########   #",
    "#                     #         ####          ####",
    "#                      #                       r #",
    "#                       ##  #######  # # # # #####",
    "#                       ##^^##    #  # # # # #####",
    "#                                 #^^ ^ ^ ^# #####",
    "#      ####################################  #####",
    "#      #                          #########  #####",
    "#      #                                     #####",
    "#      #                                     #####",
    "########                   ## #  # ## ## #########",
    "#                   # #                          #",
    "#          # ### #       #                       #",
    "#                               #   r            #",
    "#           # #       #             #            #",
    "#                           #                    #",
    "#              #  #    #                         #",
    "#                                                #",
    "#                                  ######        #",
    "#                 #  #   #       #               #",
    "#                              #                 #",
    "#                                                #",
    "#                            #              #    #",
    "#               # ##                             #",
    "#              #        #       #                #",
    "#   r         #                                  #",
    "#   #   # # ###                    ##   ###      #",
    "#                         r         ##    #      #",
    "#^^^^^^^^^^^^^^^^^^^^^^^^^#^^^^^^^^^^^#   #^^^^^^#",
    "#                                     ##F##      #",
    "#                                                #",
    "#                                                #",
    "#                                                #",
    "#                                                #",
    "#                                                #",
    "#                                                #",
    "##################################################"
  ]
}
