{
  "levelNum": 2,
  "width": 50,
  "height": 50,
  "level": [
    "00000000000000000000000000000000000000000000000000",
    "0        0                                       0",
    "0        p                                       0",
    "0   S         N   N                              0",
    "000000000   0000000000                        r  0",
    "0                                           000000",
    "0          0                                     0",
    "0                 0                           r  0",
    "0            0                              000000",
    "0               0   0                            0",
    "0                     0                          0",
    "0                      0                         0",
    "0                       0                        0",
    "0                        0                       0",
    "0                         ^ 0                    0",
    "0                                                0",
    "0                              0   0             0",
    "0                              0     0           0",
    "0                             00                 0",
    "0                           0000                 0",
    "0                         000                    0",
    "0                     0                          0",
    "0^^^^^^^^^^^^^^^^^^^     0 ^^^^^^^^^^^^^^^^^^^^^^0",
    "0                     0                          0",
    "0                        0                       0",
    "0                     0                          0",
    "0                        0                       0",
    "0                     0                          0",
    "0                  000                           0",
    "0                  0R        0                   0",
    "0                  000        0                  0",
    "0                              0                 0",
    "0                               0                0",
    "0                                                0",
    "0                      P       0                 0",
    "0                      0         0               0",
    "0                              0                 0",
    "0                                0               0",
    "0                 R            0                 0",
    "0                000             0    0          0",
    "0                                     0          0",
    "0                                     0          0",
    "0                                    F0          0",
    "0                         000  0 0  000          0",
    "0                                                0",
    "0                                                0",
    "0                                                0",
    "0                                                0",
    "0^^^^^^^^^^^^^^^^^^^^^^^^^^^^^^^^^^^^^^^^^^^^^^^^0",
    "00000000000000000000000000000000000000000000000000"
  ]
}
